==========================================================================
|   s                                                                    |
|   └────────────────────────────────────X                               |
|=======================================================                 |
|                                                                        |
|   *                                       *                            |
|                                                                        |
|                         *                                              |
|           =======================================================      |
|                                                                        |
|        *                                                               |
|                                                                        |
|==========================================================              |
|                                                                        |
|                     *                      *                           |
|                                                                        |
|        =======================================================         |
|                                                                        |
|            *                 *                     *                   |
|                                                                        |
==========================================================================
==========================================================================
|   s                                                                    |
|   └───────────────────────────────────────────────────┐                |
|=======================================================│                |
|                                                       │                |
|   X───────────────────────────────────────────────────┘                |
|                                                                        |
|                         *                                              |
|           =======================================================      |
|                                                                        |
|        *                                                               |
|                                                                        |
|==========================================================              |
|                                                                        |
|                     *                      *                           |
|                                                                        |
|        =======================================================         |
|                                                                        |
|            *                 *                     *                   |
|                                                                        |
==========================================================================
==========================================================================
|   s                                                                    |
|   └───────────────────────────────────────────────────┐                |
|=======================================================│                |
|                                                       │                |
|   X───────────────────────────────────────────────────┘                |
|                                                                        |
|                         *                                              |
|           =======================================================      |
|                                                                        |
|        *                                                               |
|                                                                        |
|==========================================================              |
|                                                                        |
|                     *                      *                           |
|                                                                        |
|        =======================================================         |
|                                                                        |
|            *                 *                     *                   |
|                                                                        |
==========================================================================
==========================================================================
|   s                                                                    |
|   └───────────────────────────────────────────────────┐                |
|=======================================================│                |
|                                                       │                |
|   *                                       *           │                |
|                                                       │                |
|                         X─────────────────────────────┘                |
|           =======================================================      |
|                                                                        |
|        *                                                               |
|                                                                        |
|==========================================================              |
|                                                                        |
|                     *                      *                           |
|                                                                        |
|        =======================================================         |
|                                                                        |
|            *                 *                     *                   |
|                                                                        |
==========================================================================
==========================================================================
|   s                                                                    |
|   └───────────────────────────────────────────────────┐                |
|=======================================================│                |
|                                                       │                |
|   *                                       *           │                |
|                                                       │                |
|          ┬────────────────────────────────────────────┘                |
|          │=======================================================      |
|          │                                                             |
|        X─┘                                                             |
|                                                                        |
|==========================================================              |
|                                                                        |
|                     *                      *                           |
|                                                                        |
|        =======================================================         |
|                                                                        |
|            *                 *                     *                   |
|                                                                        |
==========================================================================
==========================================================================
|   s                                                                    |
|   └───────────────────────────────────────────────────┐                |
|=======================================================│                |
|                                                       │                |
|   *                                       *           │                |
|                                                       │                |
|                         *                             └──────────┐     |
|           =======================================================│     |
|                                                                  │     |
|        *                                                         │     |
|                                                                  │     |
|==========================================================        │     |
|                                                                  │     |
|                     X────────────────────────────────────────────┘     |
|                                                                        |
|        =======================================================         |
|                                                                        |
|            *                 *                     *                   |
|                                                                        |
==========================================================================
==========================================================================
|   s                                                                    |
|   └───────────────────────────────────────────────────┐                |
|=======================================================│                |
|                                                       │                |
|   *                                       *           │                |
|                                                       │                |
|                         *                             └──────────┐     |
|           =======================================================│     |
|                                                                  │     |
|        *                                                         │     |
|                                                                  │     |
|==========================================================        │     |
|                                                                  │     |
|                     X────────────────────────────────────────────┘     |
|                                                                        |
|        =======================================================         |
|                                                                        |
|            *                 *                     *                   |
|                                                                        |
==========================================================================
==========================================================================
|   s                                                                    |
|   └───────────────────────────────────────────────────┐                |
|=======================================================│                |
|                                                       │                |
|   *                                       *           │                |
|                                                       │                |
|                         *                             └──────────┐     |
|           =======================================================│     |
|                                                                  │     |
|        *                                                         │     |
|                                                                  │     |
|==========================================================        │     |
|                                                                  │     |
|                     *                      *                     │     |
|                                                                  │     |
|        =======================================================   │     |
|                                                                  │     |
|            X─────────────────────────────────────────────────────┘     |
|                                                                        |
==========================================================================
==========================================================================
|   s                                                                    |
|   └───────────────────────────────────────────────────┐                |
|=======================================================│                |
|                                                       │                |
|   *                                       *           │                |
|                                                       │                |
|                         *                             └──────────┐     |
|           =======================================================│     |
|                                                                  │     |
|        *                                                         │     |
|                                                                  │     |
|==========================================================        │     |
|                                                                  │     |
|                     *                      *                     │     |
|                                                                  │     |
|        =======================================================   │     |
|                                                                  │     |
|            X─────────────────────────────────────────────────────┘     |
|                                                                        |
==========================================================================
==========================================================================
|   s                                                                    |
|   └───────────────────────────────────────────────────┐                |
|=======================================================│                |
|                                                       │                |
|   *                                       *           │                |
|                                                       │                |
|                         *                             └──────────┐     |
|           =======================================================│     |
|                                                                  │     |
|        *                                                         │     |
|                                                                  │     |
|==========================================================        │     |
|                                                                  │     |
|                     *                      *                     │     |
|                                                                  │     |
|        =======================================================   │     |
|                                                                  │     |
|            X─────────────────────────────────────────────────────┘     |
|                                                                        |
==========================================================================
